.,#,#,.,#,#,.,.,.,.,.,.,.,.,.,.,.,.,#,#,#,.,.,.,.,.,#,#,#,#,#,.,#,#,#,#,#,.,.,.,.,#,.,.,#,#,.,.,#,.,
#,.,#,#,#,#,#,#,.,#,#,.,#,#,#,#,.,.,.,#,.,#,#,.,.,.,.,#,.,.,#,.,#,.,.,#,.,#,#,.,#,#,#,#,.,#,#,.,.,.,
.,.,.,.,#,#,.,#,.,.,#,.,#,#,.,#,.,#,.,#,#,#,#,#,#,.,.,#,.,#,#,.,.,#,.,#,#,#,#,.,.,#,.,#,#,#,#,#,#,#,
#,#,.,.,.,.,#,#,#,.,.,.,.,.,.,#,.,.,#,.,.,#,.,.,#,#,#,#,.,#,#,#,.,.,#,.,.,#,.,#,.,#,#,.,.,#,.,.,.,.,
.,#,#,#,#,.,#,#,#,#,.,.,#,#,#,.,#,.,#,#,.,#,.,#,.,.,.,#,.,.,#,.,#,.,#,#,.,#,#,.,.,.,.,.,.,#,.,.,#,#,
.,.,.,.,.,.,.,#,#,#,#,#,#,.,#,#,#,.,.,#,#,#,.,.,#,#,.,#,.,.,#,#,#,.,.,#,#,.,#,.,.,#,#,.,#,#,#,#,.,.,
.,.,#,#,.,#,.,.,#,#,.,.,#,.,.,.,.,.,.,.,#,#,#,.,#,.,.,#,#,#,.,.,.,.,.,.,#,.,#,#,#,#,#,.,.,#,.,#,.,.,
#,#,.,#,.,.,.,.,.,.,.,.,#,#,.,#,#,.,#,.,.,.,.,.,#,.,.,.,.,#,.,#,#,.,#,.,#,#,#,.,.,#,.,#,.,#,#,#,#,.,
.,#,#,.,#,#,#,#,#,#,.,#,.,#,.,#,#,.,.,.,#,#,#,.,#,#,.,.,.,#,#,.,#,.,.,#,.,.,#,#,.,#,#,.,.,.,#,#,#,#,
#,.,#,#,.,.,.,.,#,#,.,.,#,#,.,#,.,#,#,#,.,.,#,.,#,#,#,.,#,.,#,#,.,#,.,.,#,.,.,#,#,.,#,.,.,.,.,.,#,.,
#,#,.,#,.,.,#,.,#,#,#,.,#,.,.,#,.,.,.,#,.,#,#,.,.,.,#,.,.,#,.,#,.,.,#,.,.,.,.,.,.,.,#,#,.,.,#,.,#,#,
.,#,#,#,#,#,#,.,.,#,.,.,#,.,#,#,#,#,#,#,.,#,#,#,#,#,.,#,.,.,#,#,#,.,.,#,#,.,#,#,#,.,#,#,#,#,.,.,.,#,
.,.,.,#,.,.,.,.,.,#,#,.,#,.,#,#,.,.,#,.,.,.,#,#,.,#,.,#,#,.,#,#,#,#,.,.,#,.,#,#,#,.,.,.,.,#,.,.,.,#,
#,#,.,#,.,#,#,.,.,.,#,.,.,.,.,.,.,.,#,.,.,.,.,.,.,#,.,.,.,.,.,#,.,#,#,#,.,.,.,#,#,#,#,#,#,#,#,.,#,#,
#,.,.,#,.,#,#,#,.,#,#,#,#,#,#,#,.,#,#,#,#,#,#,#,#,.,#,#,.,#,.,#,#,#,.,#,#,.,.,.,#,#,.,.,#,.,#,.,#,#,
#,.,.,#,.,.,#,#,.,#,.,.,.,#,#,#,.,#,#,.,.,.,#,.,#,#,.,#,.,.,#,.,.,.,.,.,#,#,.,.,.,.,#,.,#,#,.,.,.,.,
#,#,#,.,#,.,#,#,.,#,.,.,.,.,.,#,.,.,.,.,#,.,.,#,.,#,#,.,#,.,#,#,#,#,.,#,.,#,.,#,#,.,.,#,.,#,#,#,#,#,
#,.,#,#,#,.,.,.,#,#,#,.,#,#,.,#,.,#,#,#,.,#,.,#,#,.,#,#,#,.,.,.,#,#,.,.,#,#,.,#,.,#,.,.,.,.,.,.,#,#,
#,.,.,.,.,.,#,.,.,#,#,.,#,.,.,#,#,.,.,#,#,.,.,.,#,.,.,.,.,.,#,.,.,#,#,.,#,.,.,#,.,.,#,#,.,.,#,.,#,#,
#,.,.,#,#,#,#,#,.,.,.,.,#,.,.,.,#,#,#,.,#,.,.,.,#,#,.,#,#,#,#,#,.,#,.,.,#,.,.,#,#,.,#,#,#,#,#,.,.,#,
#,#,.,.,.,.,#,.,#,#,.,#,#,#,.,#,.,.,#,.,#,#,.,#,.,#,#,#,.,.,#,.,.,#,#,.,#,#,#,#,#,.,.,.,.,.,.,.,.,.,
.,#,#,#,.,.,#,#,#,#,.,.,#,#,.,.,#,.,#,.,#,#,.,.,#,.,.,.,.,.,#,.,.,.,#,.,#,.,.,#,#,#,#,#,.,#,#,.,#,#,
#,#,.,#,.,.,.,.,#,.,#,.,.,.,#,.,.,#,#,.,.,#,#,.,.,.,#,#,#,.,#,#,.,#,#,.,.,#,.,.,#,#,.,#,.,#,#,.,#,.,
.,.,.,#,#,#,.,.,#,#,.,#,#,.,.,#,.,#,#,#,.,#,.,#,#,#,#,.,#,.,#,#,.,#,#,#,.,#,.,.,.,.,.,#,.,.,.,.,#,.,
#,#,#,#,.,#,#,.,.,#,#,#,#,#,#,#,.,.,#,.,.,#,.,.,.,.,.,#,#,.,.,.,.,.,#,.,.,#,#,#,#,#,#,.,#,#,.,.,#,.,
#,.,.,.,.,.,#,#,#,.,.,#,.,.,.,.,.,.,#,.,.,#,#,#,.,#,.,#,.,#,#,#,.,.,#,.,.,.,.,.,#,.,#,#,.,#,#,#,.,#,
#,.,#,#,.,#,.,.,#,#,.,#,.,.,#,#,#,#,#,#,#,#,.,#,#,#,.,#,#,#,.,#,#,.,#,#,.,.,#,.,#,.,.,#,#,#,.,#,.,.,
#,.,#,#,.,.,#,.,.,.,#,#,#,#,.,.,.,.,#,.,.,.,.,.,.,.,#,.,.,.,#,.,#,.,#,#,#,#,#,.,#,.,#,.,.,.,#,#,#,.,
#,.,#,.,#,.,.,.,#,.,.,.,.,#,.,.,#,.,#,.,#,#,.,.,#,.,#,#,#,.,.,#,#,.,#,#,.,.,.,#,#,.,#,#,#,.,#,#,#,#,
.,.,#,#,.,#,#,#,#,#,#,#,#,#,#,#,#,.,#,.,#,#,#,#,#,.,.,.,.,#,.,#,.,.,.,.,.,#,.,#,#,.,.,.,.,.,.,#,.,#,
.,#,.,#,.,#,.,.,#,#,.,.,#,.,.,.,.,#,#,.,.,#,.,.,.,.,#,#,.,#,.,#,.,.,#,#,.,#,.,.,.,.,#,#,.,#,.,#,#,.,
.,.,#,#,.,#,.,.,.,.,#,.,#,#,.,#,.,#,.,#,.,#,.,#,#,#,.,#,.,.,#,#,#,#,#,#,.,#,.,#,#,#,.,#,.,#,#,.,#,.,
#,.,#,.,.,#,#,.,#,.,.,#,.,#,.,#,.,#,#,.,.,#,#,.,.,#,#,.,#,.,.,.,.,.,#,.,.,#,#,#,.,#,#,.,.,.,#,.,#,#,
.,.,#,.,#,.,#,#,.,#,.,.,.,#,.,#,#,.,#,.,.,.,#,.,#,.,#,#,#,#,#,#,.,.,#,.,#,.,.,#,#,.,#,.,#,.,#,.,#,.,
.,.,#,.,.,#,.,#,.,.,#,#,#,.,.,.,#,.,#,#,.,#,#,.,#,#,.,.,#,#,.,#,.,.,#,.,.,.,.,.,#,.,#,.,.,#,#,.,.,.,
#,.,.,#,.,.,#,#,#,.,#,.,#,.,#,.,#,#,#,#,.,#,#,.,.,#,.,.,.,.,.,#,#,.,.,#,#,.,.,.,#,.,.,#,.,#,#,#,#,.,
#,#,.,#,#,.,#,#,#,.,.,#,#,.,.,#,.,.,.,#,.,.,.,.,.,#,.,.,#,#,#,#,#,#,.,.,#,#,.,#,#,#,#,.,.,.,#,#,#,#,
.,#,.,.,.,.,.,#,.,#,.,#,.,#,.,.,#,#,.,#,.,#,#,.,#,#,#,#,#,.,.,#,.,#,#,.,#,#,.,#,#,.,#,.,.,.,.,#,.,.,
#,.,#,#,#,#,.,#,#,.,.,#,.,.,#,.,#,.,.,#,#,.,#,.,#,#,.,.,#,.,.,#,#,#,#,.,#,#,.,.,.,#,#,#,#,#,.,#,.,.,
#,#,.,.,.,.,#,.,#,.,#,#,#,.,.,.,#,.,.,.,#,#,.,.,.,.,.,.,#,#,#,.,.,#,#,.,.,.,.,#,.,#,#,.,.,#,#,#,#,.,
.,#,.,.,#,.,#,.,#,.,#,#,#,#,.,#,#,#,.,#,.,#,#,#,#,#,.,#,.,.,.,#,.,.,.,.,#,#,.,#,.,.,.,.,.,.,.,#,#,#,
#,#,#,#,#,.,#,.,.,.,.,#,#,#,.,.,#,#,.,.,.,.,.,.,#,#,.,.,#,#,.,.,.,#,#,#,.,#,.,#,.,#,#,.,.,#,.,#,#,.,
.,#,.,.,.,#,#,#,.,#,.,.,#,.,#,.,.,.,#,#,.,.,#,.,#,#,#,.,#,.,#,#,.,#,.,#,#,.,.,#,#,.,#,#,#,.,.,.,#,.,
.,#,.,#,.,#,.,#,.,#,.,.,#,#,.,#,#,.,#,#,#,#,#,.,.,#,.,.,#,#,.,#,.,#,#,.,#,.,.,.,#,.,#,.,#,.,.,.,#,#,
.,#,#,#,.,#,#,.,.,#,#,.,.,#,#,#,#,.,#,#,.,.,.,.,.,#,#,.,.,#,#,.,.,.,#,#,#,#,.,#,#,.,#,.,#,#,.,#,.,#,
.,.,.,#,#,.,#,.,.,.,#,#,#,.,.,#,.,.,.,.,.,#,#,.,.,.,#,#,#,.,#,.,.,.,.,.,#,#,.,#,#,.,#,.,#,#,.,.,#,#,
.,.,.,.,#,#,#,#,.,#,.,.,.,#,.,#,.,.,#,#,.,#,#,#,.,#,.,.,.,.,#,#,.,.,#,.,.,.,.,.,.,#,#,.,.,#,#,.,#,.,
#,.,#,.,.,.,#,#,.,.,#,#,.,.,#,#,#,#,#,#,.,.,#,#,.,.,#,#,#,.,#,#,#,#,#,#,#,#,.,#,.,#,#,#,.,#,.,.,#,#,
#,.,.,.,#,.,#,#,#,.,#,.,#,.,.,.,.,.,#,.,#,.,.,.,#,.,#,#,#,.,.,.,.,.,#,#,.,#,#,#,.,.,#,.,.,#,#,.,.,#,
.,#,#,#,#,.,.,#,.,.,#,#,#,#,#,#,.,.,#,#,.,#,#,.,.,.,.,#,#,#,#,#,.,.,.,.,.,.,.,.,.,.,#,.,.,.,#,#,#,.,